1111111111111111111111111111111111
1E00000000000010000000000000000001
1110011110100C001010C1000100010101
10100100101011100011110001C0010101
1P00000100C00000000000000110110001
1000010100100000101001000000010101
10100100001010100C10010000000001C1
1111111111111111111111111111111111