1111111111111111111111111111111111
1E00000000000000000000000000000001
1011110111100100001111011010111101
101C000100100100001001011010100001
1011110100100100001001010110101101
10000101001001C000100101011010C101
1011110111100111101111010010111101
1P00000000000000000000000000000001
1111111111111111111111111111111111