111111111111111111111111
1000000000C00000C00000EC
10000000000000P000000001
111111111111111111111111