11111111
1000000C
1P11CE11
11111111