11111111111111111
1ECCCCCCCCCCCCCC1
1C1111111111111C1
1PCCCCCCCCCCCCCC1
11111111111111111