111111111
1C00010C1
100101001
1P01000E1
111111111